##########
##########
##### ####
###G   C #
# CG#  C #
# ###G # #
#      G #
# C#GJC  #
##      ##
##########