##########
##########
######  ##
####    ##
# CG  CG##
#   #   ##
# C  CG###
# JG## ###
##########
##########