##########
##########
## ###GC #
#        #
# # ######
# C J G###
##########
##########
##########
##########
