##########
###  #####
## C   J##
##  G#####
#  #######
# C   G###
# ## ##G##
# C     ##
######  ##
##########