##########
##########
#####G####
##G    J##
#  C     #
# G##G C #
# ###  ###
# C  C ###
#####  ###
##########