##########
##########
#   G#####
#  #  ####
## #   C #
## #G##  #
## #### ##
##C    J##
##  ######
##########