##########
##  ######
##  J  ###
##G##   ##
##GG  C ##
##### #G #
##### #C #
### CC#  #
###     ##
##########