##########
#####  ###
# C     ##
# J# CG  #
####G CC #
### G  G##
###C# ####
##G   ####
##########
##########