##########
##  ######
## C##J###
##  ##G###
##  #G  ##
#   GC C #
# C    G #
######  ##
##########
##########