##########
##########
#  G J G##
#  C# ####
## G    ##
## ## C ##
## ##  ###
##C   ####
##  ######
##########