#########
#G    C #
######G #
######  #
######G #
######  #
#JC   C #
####    #
#########