##########
##########
##########
###### J##
##  ## ###
# C ##  ##
#       ##
### CG#G##
##########
##########