##########
##########
##G   ####
### C ####
###G #####
###     ##
### J CC##
###G  CG##
#####  ###
##########