##########
##    ####
## CC ####
####  ####
###  G J##
#       ##
# C  G# ##
###  ##G##
##########
##########