##########
#####    #
#####C C #
#####  ###
###   ####
###C#G####
##  #GJ ##
##  G#####
##########
##########
