##########
##########
##   #####
##    G###
##GC#C ###
###     ##
####### ##
#######J##
##########
##########
