##########
####  ####
### C ####
## G   G##
## #C##J##
#  C    ##
# G   ####
# C  G####
###  #####
##########