##########
##     ###
##  G#CC #
# C GG   #
#    C  ##
## J# G###
##  C   ##
##G     ##
##########
##########