##########
#  #######
#  GGC  ##
# ### #J##
#   GC  ##
# C C   ##
# G #  G##
##  # C###
#####  ###
##########