##########
#####  ###
#####C  ##
##  C   ##
## C# # ##
##J #  G##
###GG  ###
##########
##########
##########