#########
#       #
# J     #
#       #
#       #
#      G#
#    C  #
#       #
#########